11111111
10000001
10000001
10000111
10P00EC1
10000111
10000001
11111111
