11111111
10E00001
100C0001
10011111
10P1C001
10011001
1C000011
11111111