NO ./path_to_the_north_texture
SO ./path_to_the_south_texture
WE ./path_to_the_west_texture
EA 

F 128,128,128
C 51,153,255

111111111111111111111111111111111111111111111111111111111111111111
100000E00000110000000000000000000000000000001100000000000000000001
101111011110110111101111011111111111111011101101111011111011111101
101111011110110111101111011111111111111011101101111011111011111101
101111011110110111101111011111111111111011101101111011111011111101
100000000000000000000000000000000000000000000000000000000000000001
101111010111111110101111011111011111110111111101011110111111011101
100000000000110000100000000000000000000000000001100001000000000001
111111011110110111101111111111011111011111111011101101111011111111
111111010000000000101111111111010000000001111101000000000101111111
111111010111001110101111111110101110011101111010111100111010111111
100000000100000010000000000000010000000100000000100000010000000001
111111010111111110101111111111010111111110101111101011111110101111
111111010000000000101111111111010000000001011110101000000001011111
111111010111111110101111111111010111111110101111101011111110101111
100000000000110000000000000000000000000000001100000000000000000001
101111011110110111101111011111111111111011101101111011111011111101
100011000000000000001100010000000000000000000000110000000011000001
111011010111111110101101111111111111111111111111111111111111111111
1000000100001100001000000000000000000000000000000000011000010000001
101111111110110111111111011111111111111111111111011101101111111101
100000000000000000000000000000000000000000000000000000000000000001
100000000000110000000000000000000000000000001100000000000000000001
101111011110110111101111011111111111111011101101111011111011111101
101111011110110111101111011111111111111011101101111011111011111101
101111011110110111101111011111111111111011101101111011111011111101
100000000000000000000000000000000000000000000000000000000000000001
101111010111111110101111011111011111110111111101011110111111011101
100000000000110000100000000000000000000000000001100001000000000001
111111011110110111101111111111011111011111111011101101111011111111
111111010000000000101111111111010000000001111101000000000101111111
111111010111001110101111111110101110011101111010111100111010111111
100000000100000010000000000000010000000100000000100000010000000001
111111010111111110101111111111010111111110101111101011111110101111
111111010000000000101111111111010000000001011110101000000001011111
111111010111111110101111111111010111111110101111101011111110101111
100000000000110000000000000000000000000000001100000000000000000001
100000000000110000000000000000000000000000001100000000000000000001
101111011110110111101111011111111111111011101101111011111011111101
100011000000000000001100010000000000000000000000110000000011000001
111011010111111110101101111111111111111111111111111111111111111111
100000010000110000100000000000000000000000000000000011000010000001
101111111110110111111111011111111111111111111111011101101111111101
100000000000000000000000000000000000000000000000000000000000000001
111111111111111111111111111111111111111000000111111111111111111111
100000000000000000000000000000000000000000000000000000000000000001
101111011111111111111111111111111111111111111111111111111111111101
101111000000000000000000000000000000000000000000000000000000011101
101111011111111111111111111111111111111111111111111111111111011101
100000000000000000000000000000000000000000000000000000000000000001
101111111111111111111111111111111111111111111111111111111111111101
100000000000000000000000000000000000000000000000000000000000000001
111111111111111111111111111111111111111111111111111111111111111111